12 7
# # # # # # # # # # # #
# . . . . . . . . . . #
# . . W . . . . W . . #
# P . . . . . . . . . #
# . . . . . . . . . . #
# . . . . . W . . . . #
# # # # # # # # # # # #
